{
    "images": {
        "1": "Images/221B.jpg",
        "2": "Images/Chemist.jpg",
        "3": "Images/NewsAgent.jpg",
        "4": "Images/Locksmith.jpg",
        "5": "Images/Park.jpg",
        "6": "Images/Hotel.jpg",
        "7": "Images/Tobacconist.jpg",
        "8": "Images/Pawnbroker.jpg",
        "9": "Images/CarriageDepot.jpg",
        "10": "Images/Thearte.jpg",
        "11": "Images/TheBoarsHead.jpg",
        "12": "Images/ScotlandYard.jpg",
        "13": "Images/Bank.jpg",
        "14": "Images/Museum.jpg",
        "15": "Images/Docks.jpg",
        "16": "Images/Lampost.jpg"
    },
    "grid": [
        [1, 1, 1, 1, 1, 1, 1, 16, 2, 2, 2, 2, 16, 3, 3, 3, 3, 16, 4, 4, 4, 4, 4, 16],
        [1, 1, 1, 1, 1, 1, 1, 16, 2, 2, 2, 2, 16, 3, 3, 3, 3, 16, 4, 4, 4, 4, 4, 16],
        [1, 1, 1, 1, 1, 1, 1, 16, 2, 2, 2, 2, 16, 3, 3, 3, 3, 16, 4, 4, 4, 0, 4, 16],
        [1, 1, 1, 1, 0, 1, 1, 16, 2, 0, 2, 2, 16, 3, 0, 3, 3, 0, 0, 0, 0, 0, 0, 0],
        [0, 0, 0, 0, 0, 0, 0, 0, 0, 0, 0, 0, 0, 0, 0, 0, 0, 0, 8, 8, 8, 8, 8, 0],
        [0, 5, 5, 0, 6, 6, 6, 6, 6, 0, 7, 7, 7, 7, 7, 7, 7, 0, 8, 8, 8, 8, 8, 0],
        [5, 5, 5, 0, 6, 6, 6, 6, 6, 0, 7, 7, 7, 7, 7, 7, 7, 0, 0, 8, 8, 8, 8, 0],
        [5, 5, 5, 0, 6, 6, 6, 6, 6, 0, 7, 7, 7, 7, 7, 7, 7, 0, 8, 8, 8, 8, 8, 0],
        [5, 5, 5, 0, 6, 6, 6, 6, 6, 0, 7, 7, 7, 7, 0, 7, 7, 0, 16, 16, 16, 16, 16, 0],
        [5, 5, 5, 0, 0, 6, 6, 6, 6, 0, 0, 0, 0, 0, 0, 0, 0, 0, 16, 16, 16, 16, 16, 0],
        [5, 5, 0, 0, 6, 6, 6, 6, 6, 0, 10, 10, 10, 10, 10, 10, 10, 0, 11, 11, 11, 11, 11, 0],
        [5, 5, 5, 0, 6, 6, 6, 6, 6, 0, 10, 10, 10, 10, 10, 10, 10, 0, 11, 11, 11, 11, 0, 0],
        [5, 5, 5, 0, 9, 9, 9, 9, 9, 0, 0, 10, 10, 10, 10, 10, 10, 0, 11, 11, 11, 11, 11, 0],
        [5, 5, 5, 0, 9, 9, 9, 9, 9, 0, 10, 10, 10, 10, 10, 10, 10, 0, 11, 11, 11, 11, 11, 0],
        [5, 5, 5, 0, 9, 9, 9, 9, 9, 0, 10, 10, 10, 10, 10, 10, 10, 0, 11, 11, 11, 11, 11, 0],
        [5, 5, 5, 0, 0, 9, 9, 9, 9, 0, 10, 10, 10, 10, 10, 10, 10, 0, 0, 0, 0, 0, 0, 0],
        [5, 5, 5, 0, 9, 9, 9, 9, 9, 0, 16, 16, 16, 16, 16, 16, 16, 0, 15, 15, 15, 15, 15, 0],
        [0, 5, 5, 0, 9, 9, 9, 9, 9, 0, 0, 0, 0, 0, 0, 0, 0, 0, 15, 15, 15, 15, 15, 15],
        [0, 5, 5, 0, 9, 9, 9, 9, 9, 0, 14, 14, 0, 14, 14, 14, 16, 0, 15, 15, 15, 15, 15, 15],
        [0, 0, 0, 0, 0, 0, 0, 0, 0, 0, 14, 14, 14, 14, 14, 14, 16, 0, 15, 15, 15, 15, 15, 15],
        [12, 12, 12, 0, 12, 12, 13, 13, 13, 0, 14, 14, 14, 14, 14, 14, 16, 0, 15, 15, 15, 15, 15, 15],
        [12, 12, 12, 12, 12, 12, 13, 13, 13, 0, 14, 14, 14, 14, 14, 14, 16, 0, 15, 15, 15, 15, 15, 15],
        [12, 12, 12, 12, 12, 12, 13, 13, 0, 0, 14, 14, 14, 14, 14, 14, 16, 0, 0, 15, 15, 15, 15, 15],
        [12, 12, 12, 12, 12, 12, 13, 13, 13, 0, 0, 0, 0, 0, 0, 0, 0, 0, 15, 15, 15, 15, 15, 15]
    ]
}