{
    "grid": [
        [9, 9, 9, 9, 9, 9, 9, 2, 1, 1, 1, 1, 2, 8, 8, 8, 8, 2, 1, 1, 1, 1, 1, 2],
        [9, 9, 9, 9, 9, 9, 9, 2, 1, 1, 1, 1, 2, 8, 8, 8, 8, 2, 1, 1, 1, 1, 1, 2],
        [9, 9, 9, 9, 9, 9, 9, 2, 1, 1, 1, 1, 2, 8, 8, 8, 8, 2, 1, 1, 1, 0, 1, 2],
        [9, 9, 9, 9, 0, 9, 9, 2, 1, 0, 1, 1, 2, 8, 0, 8, 8, 0, 0, 0, 0, 0, 0, 0],
        [0, 0, 0, 0, 0, 0, 0, 0, 0, 0, 0, 0, 0, 0, 0, 0, 0, 0, 12, 12, 12, 12, 12, 0],
        [0, 3, 3, 0, 1, 1, 1, 1, 1, 0, 12, 12, 12, 12, 12, 12, 12, 0, 12, 12, 12, 12, 12, 0],
        [3, 3, 3, 0, 1, 1, 1, 1, 1, 0, 12, 12, 12, 12, 12, 12, 12, 0, 0, 12, 12, 12, 12, 0],
        [3, 3, 3, 0, 1, 1, 1, 1, 1, 0, 12, 12, 12, 12, 12, 12, 12, 0, 12, 12, 12, 12, 12, 0],
        [3, 3, 3, 0, 1, 1, 1, 1, 1, 0, 12, 12, 12, 12, 0, 12, 12, 0, 2, 2, 2, 2, 2, 0],
        [3, 3, 3, 0, 0, 1, 1, 1, 1, 0, 0, 0, 0, 0, 0, 0, 0, 0, 2, 2, 2, 2, 2, 0],
        [3, 3, 0, 0, 1, 1, 1, 1, 1, 0, 5, 5, 5, 5, 5, 5, 5, 0, 1, 1, 1, 1, 1, 0],
        [3, 3, 3, 0, 1, 1, 1, 1, 1, 0, 5, 5, 5, 5, 5, 5, 5, 0, 1, 1, 1, 1, 0, 0],
        [3, 3, 3, 0, 13, 13, 13, 13, 13, 0, 0, 5, 5, 5, 5, 5, 5, 0, 1, 1, 1, 1, 1, 0],
        [3, 3, 3, 0, 13, 13, 13, 13, 13, 0, 5, 5, 5, 5, 5, 5, 5, 0, 1, 1, 1, 1, 1, 0],
        [3, 3, 3, 0, 13, 13, 13, 13, 13, 0, 5, 5, 5, 5, 5, 5, 5, 0, 1, 1, 1, 1, 1, 0],
        [3, 3, 3, 0, 0, 13, 13, 13, 13, 0, 5, 5, 5, 5, 5, 5, 5, 0, 0, 0, 0, 0, 0, 0],
        [3, 3, 3, 0, 13, 13, 13, 13, 13, 0, 2, 2, 2, 2, 2, 2, 2, 0, 10, 10, 10, 10, 10, 0],
        [0, 3, 3, 0, 13, 13, 13, 13, 13, 0, 0, 0, 0, 0, 0, 0, 0, 0, 10, 10, 10, 10, 10, 10],
        [0, 3, 3, 0, 13, 13, 13, 13, 13, 0, 5, 5, 0, 5, 5, 5, 2, 0, 10, 10, 10, 10, 10, 10],
        [0, 0, 0, 0, 0, 0, 0, 0, 0, 0, 5, 5, 5, 5, 5, 5, 2, 0, 10, 10, 10, 10, 10, 10],
        [1, 1, 1, 0, 1, 1, 14, 14, 14, 0, 5, 5, 5, 5, 5, 5, 2, 0, 10, 10, 10, 10, 10, 10],
        [1, 1, 1, 1, 1, 1, 14, 14, 14, 0, 5, 5, 5, 5, 5, 5, 2, 0, 10, 10, 10, 10, 10, 10],
        [1, 1, 1, 1, 1, 1, 14, 14, 0, 0, 5, 5, 5, 5, 5, 5, 2, 0, 0, 10, 10, 10, 10, 10],
        [1, 1, 1, 1, 1, 1, 14, 14, 14, 0, 0, 0, 0, 0, 0, 0, 0, 0, 10, 10, 10, 10, 10, 10]
    ]
}